##########
#        #
#        #
#   OPX###
#        #
# OX     #
##########